á=α
Ü=ά
Á=Α
¢=Ά
â=β
Â=Β
ã=γ
Ã=Γ
ä=δ
Ä=Δ
å=ε
Ý=έ
Å=Ε
¸=Έ
æ=ζ
Æ=Ζ
ç=η
Þ=ή
Ç=Η
¹=Ή
è=θ
È=Θ
é=ι
ß=ί
ú=ϊ
À=ΐ
É=Ι
Ú=Ϊ
ê=κ
Ê=Κ
ë=λ
Ë=Λ
ì=μ
Ì=Μ
í=ν
Í=Ν
î=ξ
Î=Ξ
ï=ο
ü=ό
Ï=Ο
¼=Ό
ð=π
Ð=Π
ñ=ρ
Ñ=Ρ
ó=σ
ò=ς
Ó=Σ
ô=τ
Ô=Τ
õ=υ
ý=ύ
û=ϋ
Õ=Υ
ö=φ
Ö=Φ
÷=χ
×=Χ
ø=ψ
Ø=Ψ
ù=ω
þ=ώ
Ù=Ω
¿=Ώ
=´
~=´
¾=Ύ
